[MAP]
22x320
  1   2   3   4   5   3   4   3   2   3   4   2   2   4   2   2   2   3   4   2   3   2   4   5   4   3   2   2   5   3   4   3   2   3   4   2   2   4   2   2   2   4   4   3   3   2   4   2   2   3   4   2   4   3   2   2   5   3   4   3   4   2   2   2   4   2   4   2   4   2   2   4   2   3   4   2   3   2   4   5   2   3   4   2   2   4   2   2   2   3   4   2   5   3   4   3   2   3   4   2   3   2   4   5   2   4   2   2   4   2   2   2   4   2   4   2   2   3   4   2   2   4   2   2   5   3   4   3   2   3   4   2   3   2   4   5   5   3   4   3   2   4   2   2   4   2   2   2   4   2   4   2   4   4   2   4   4   2   4   2   2   4   5   4   2   4   2   2   3   2   4   5   4   3   2   2   4   2   2   2   4   4   2   4   2   3   4   2   2   3   4   5   2   4   2   2   2   3   4   2   4   2   4   2   4   4   2   4   2   4   4   3   4   3   2   5   3   2   4   2   3   2   4   5   5   3   4   3   4   3   2   2   2   4   2   2   2   4   2   2   2   3   4   2   5   3   4   3   3   2   4   5   2   4   4   3   4   3   2   5   3   2   4   2   4   3   2   2   2   4   2   2   2   4   4   3   3   2   4   2   3   2   4   5   2   4   4   3   4   3   2   5   3   2   4   2   4   3   2   2   2   4   4   3   3   2   4   2   2   4   4   3   3   2   4   2   3   2   5   6 
  0   7   7   0   0   8   0   7   9  10  11  12   0   0   0  13   9  10   9  14   8   0   0   0   0   7  15  13   0   8   0   7   9  10   9  14   0   0  16  17  18  19  20  21  20  21  22  23   9  10   9  14   0   7  15  13   0   8   0   0   9   9  10  11  11   9  14  12  24  25  26  27   9  10  11   0   0   0   0   0   0  10   9  14   0   0   0   0   9  10  11  12   0   8   0   7   9  10   9  14   8   0   0   0   0   0   0  13   9   9  10  11  11   9  14  12   9  10   9  14   0   0   0  13   0   8   0   7   9  10  11  12   8   0   0   0   0   8   0   0   0   0   0   0   9   9  10  11  11   9  14  12  28  29  30  31  11   9  14  12  10  14   0   0   0   0   0  13   8   0   0   0   0   7  15  13   9   9  10  11  28  29  30  31  32  10  11  12   0   0   0   0   0   0   0  13   9  10   9  14  11   9  14  12  28  29  30  31  18  19  20  21  20  21  20  21  20  21  22  23   8   0   0   0   0   8   0   7   0   7  15  13   0   0   0  13   0   0   0   0   9  33   9  14   0   8   0   7   8   0   0   0  18  19  20  21  20  21  20  21  20  21  22  23   0   7  15  13   0   0   0  13  18  19  20  21  20  21  22  23   8   0   0   0  18  19  20  21  20  21  20  21  20  21  22  23   0   7  15  13  18  19  20  21  20  21  22  23  18  19  20  21  20  21  22  23   7  15   0   0 
  0   0   0   0   0   0   0   0   0   9  14   0   0   0   0   0   0  15   0   0   0   0   0   0   0   0   0   0   0   0   0   0   0  15   0   0   0   0  34  35  16  17  36  37  36  37  38  16  17  15   0   0   0   0   0   0   0   0   0   0   0   0   9  11  39  40  14  41  42  43  44  45   0   9  14   0   0   0   0   0   0  15   0   0   0   0   0   0   0   9  14   0   0   0   0   0   0  15   0   0   0   0   0   0   0   0   0   0   0   0   9  11  39  40  14  41   0  15   0   0   0   0   0   0   0   0   0   0   0   9  14   0   0   0   0   0   0   0   0   0   0   0   0   0   0   0   9  11  39  40  14  41  46  47  48  41  39  40  14  41  14   0   0   0   0   0   0   0   0   0   0   0   0   0   0   0   0   0   9  11  46  47  49  41   0   9  14   0   0   0   0   0   0   0   0   0   0  15   0   0  39  40  14  41  46  50  51  41   0  52  36  37  19  53  53  22  36  37  38   0   0   0   0   0   0   0   0   0   0   0   0   0   0   0   0   0   0   0   0   0   0  15   0   0   0   0   0   0   0   0   0   0   0  52  36  37  19  53  53  22  36  37  38   0   0   0   0   0   0   0   0   0   0  52  36  37  36  37  38   0   0   0   0   0   0  52  36  37  19  53  53  22  36  37  38   0   0   0   0   0   0  52  36  37  36  37  38   0   0  52  36  37  36  37  38   0   0   0   0   0 
  0   0   0   0   0   0   0   0   0   0   0   0   0   0   0   0   0   0   0   0   0   0   0   0   0   0   0   0   0   0   0   0   0   0   0   0   0   0   0   0  34  35  53  23  18  53  23  34  35   0   0   0   0   0   0   0   0   0   0   0   0   0   0   9  54  55  56  41   0   0   0   0   0   0   0   0   0   0   0   0   0   0   0   0   0   0   0   0   0   0   0   0   0   0   0   0   0   0   0   0   0   0   0   0   0   0   0   0   0   0   0   9  54  55  56  41   0   0   0   0   0   0   0   0   0   0   0   0   0   0   0   0   0   0   0   0   0   0   0   0   0   0   0   0   0   0   0   9  54  55  56  41  54  55  56  57  54  55  56  41   0   0   0   0   0   0   0   0   0   0   0   0   0   0   0   0   0   0   0   9  54  55  56  57   0   0   0   0   0   0   0   0   0   0   0   0   0   0   0   0  54  55  56  41  54  55  56  57   0  18  53  23  18  19  22  23  18  53  23   0   0   0   0   0   0   0   0   0   0   0   0   0   0   0   0   0   0   0   0   0   0   0   0   0   0   0   0   0   0   0   0   0   0  18  53  23  18  19  22  23  18  53  23   0   0   0   0   0   0   0   0   0   0  18  53  23  18  53  23   0   0   0   0   0   0  18  53  23  18  19  22  23  18  53  23   0   0   0   0   0   0  18  53  23  18  53  23   0   0  18  53  23  18  53  23   0   0   0   0   0 
  0   0   0   0   0   0   0   0   0   0   0   0   0   0   0   0   0   0   0   0   0   0   0   0   0   0   0   0   0   0   0   0   0   0   0   0   0   0   0   0   0   0   0   0   0   0   0   0   0   0   0   0   0   0   0   0   0   0   0   0   0   0   0   0  24  25  26  58   0   0   0   0   0   0   0   0   0   0   0   0   0   0   0   0   0   0   0   0   0   0   0   0   0   0   0   0   0   0   0   0   0   0   0   0   0   0   0   0   0   0   0   0  24  25  26  58   0   0   0   0   0   0   0   0   0   0   0   0   0   0   0   0   0   0   0   0   0   0   0   0   0   0   0   0   0   0   0   0  24  25  26  58  59  60  61  62  24  25  26  58   0   0   0   0   0   0   0   0   0   0   0   0   0   0   0   0   0   0   0   0  59  60  61  62   0   0   0   0   0   0   0   0   0   0   0   0   0   0   0   0  24  25  26  58  39  63  40  64   0   0   0   0   0   0   0   0   0   0   0   0   0   0   0   0   0   0   0   0   0   0   0   0   0   0   0   0   0   0   0   0   0   0   0   0   0   0   0   0   0   0   0   0   0   0   0   0   0   0   0   0   0   0   0   0   0   0   0   0   0   0   0   0   0   0   0   0   0   0   0   0   0   0   0   0   0   0   0   0   0   0   0   0   0   0   0   0   0   0   0   0   0   0   0   0   0   0   0   0   0   0   0   0   0   0   0   0   0   0   0   0 
  0   0   0   0   0   0   0   0   0   0   0   0   0   0   0   0   0   0   0   0   0   0   0   0   0   0   0   0   0   0   0   0   0   0   0   0   0   0   0   0   0   0   0   0   0   0   0   0   0   0   0   0   0   0   0   0   0   0   0   0   0   0   0   0  42  43  44  65   0   0   0   0   0   0   0   0   0   0   0   0   0   0   0   0   0   0   0   0   0   0   0   0   0   0   0   0   0   0   0   0   0   0   0   0   0   0   0   0   0   0   0   0  42  43  44  65   0   0   0   0   0   0   0   0   0   0   0   0   0   0   0   0   0   0   0   0   0   0   0   0   0   0   0   0   0   0   0   0  42  43  44  45  24  25  66  58  42  43  44  45   0   0   0   0   0   0   0   0   0   0   0   0   0   0   0   0   0   0   0   0  24  25  66  58   0   0   0   0   0   0   0   0   0   0   0   0   0   0   0   0  42  43  44  65  67  40  68  41   0   0   0   0   0   0   0   0   0   0   0   0   0   0   0   0   0   0   0   0   0   0   0   0   0   0   0   0   0   0   0   0   0   0   0   0   0   0   0   0   0   0   0   0   0   0   0   0   0   0   0   0   0   0   0   0   0   0   0   0   0   0   0   0   0   0   0   0   0   0   0   0   0   0   0   0   0   0   0   0   0   0   0   0   0   0   0   0   0   0   0   0   0   0   0   0   0   0   0   0   0   0   0   0   0   0   0   0   0   0   0   0 
  0   0   0   0   0   0   0   0   0   0   0   0   0   0   0   0   0   0   0   0   0   0   0   0   0   0   0   0   0   0   0   0   0   0   0   0   0   0   0   0   0   0   0   0   0   0   0   0   0   0   0   0   0   0   0   0   0   0   0   0   0   0   0   0   0   0   0   0   0   0   0   0   0   0   0   0   0   0   0   0   0   0   0   0   0   0   0   0   0   0   0   0   0   0   0   0   0   0   0   0   0   0   0   0   0   0   0   0   0   0   0   0   0   0   0   0   0   0   0   0   0   0   0   0   0   0   0   0   0   0   0   0   0   0   0   0   0   0   0   0   0   0   0   0   0   0   0   0   0   0   0   0  42  43  69  45   0   0   0   0   0   0   0   0   0   0   0   0   0   0   0   0   0   0   0   0   0   0   0   0  42  43  69  45   0   0   0   0   0   0   0   0   0   0   0   0   0   0   0   0   0   0   0   0  54  55  56  57   0   0   0   0   0   0   0   0   0   0   0   0   0   0   0   0   0   0   0   0   0   0   0   0   0   0   0   0   0   0   0   0   0   0   0   0   0   0   0   0   0   0   0   0   0   0   0   0   0   0   0   0   0   0   0   0   0   0   0   0   0   0   0   0   0   0   0   0   0   0   0   0   0   0   0   0   0   0   0   0   0   0   0   0   0   0   0   0   0   0   0   0   0   0   0   0   0   0   0   0   0   0   0   0   0   0   0   0   0   0   0   0 
  0   0   0   0   0   0   0   0   0   0   0   0   0   0   0   0   0   0   0   0   0   0   0   0   0   0   0   0   0   0   0   0   0   0   0   0   0   0   0   0   0   0   0   0   0   0   0   0   0   0   0   0   0   0   0   0   0   0   0   0   0   0   0   0   0   0   0   0   0   0   0   0   0   0   0   0   0   0   0   0   0   0   0   0   0   0   0   0   0   0   0   0   0   0   0   0   0   0   0   0   0   0   0   0   0   0   0   0   0   0   0   0   0   0   0   0   0   0   0   0   0   0   0   0   0   0   0   0   0   0   0   0   0   0   0   0   0   0   0   0   0   0   0   0   0   0   0   0   0   0   0   0   0   0   0   0   0   0   0   0   0   0   0   0   0   0   0   0   0   0   0   0   0   0   0   0   0   0   0   0   0   0   0   0   0   0   0   0   0   0   0   0   0   0   0   0   0   0   0   0   0   0   0   0  70  60  61  71   0   0   0   0   0   0   0   0   0   0   0   0   0   0   0   0   0   0   0   0   0   0   0   0   0   0   0   0   0   0   0   0   0   0   0   0   0   0   0   0   0   0   0   0   0   0   0   0   0   0   0   0   0   0   0   0   0   0   0   0   0   0   0   0   0   0   0   0   0   0   0   0   0   0   0   0   0   0   0   0   0   0   0   0   0   0   0   0   0   0   0   0   0   0   0   0   0   0   0   0   0   0   0   0   0   0   0   0   0   0   0   0 
  0   0   0   0   0   0   0   0   0   0   0   0   0   0   0   0   0   0   0   0   0   0   0   0   0   0   0   0   0   0   0   0   0   0   0   0   0   0   0   0   0   0   0   0   0   0   0   0   0   0   0   0   0   0   0   0   0   0   0   0   0   0   0   0   0   0   0   0   0   0   0   0   0   0   0   0   0   0   0   0   0   0   0   0   0   0   0   0   0   0   0   0   0   0   0   0   0   0   0   0   0   0   0   0   0   0   0   0   0   0   0   0   0   0   0   0   0   0   0   0   0   0   0   0   0   0   0   0   0   0   0   0   0   0   0   0   0   0   0   0   0   0   0   0   0   0   0   0   0   0   0   0   0   0   0   0   0   0   0   0   0   0   0   0   0   0   0   0   0   0   0   0   0   0   0   0   0   0   0   0   0   0   0   0   0   0   0   0   0   0   0   0   0   0   0   0   0   0   0   0   0   0   0   0  24  25  26  58   0   0   0   0   0   0   0   0   0   0   0   0   0   0   0   0   0   0   0   0   0   0   0   0   0   0   0   0   0   0   0   0   0   0   0   0   0   0   0   0   0   0   0   0   0   0   0   0   0   0   0   0   0   0   0   0   0   0   0   0   0   0   0   0   0   0   0   0   0   0   0   0   0   0   0   0   0   0   0   0   0   0   0   0   0   0   0   0   0   0   0   0   0   0   0   0   0   0   0   0   0   0   0   0   0   0   0   0   0   0   0   0 
  0   0   0   0   0   0   0   0   0   0   0   0   0   0   0   0   0   0   0   0   0   0   0   0   0   0   0   0   0   0   0   0   0   0   0   0   0   0   0   0   0   0   0   0   0   0   0   0   0   0   0   0   0   0   0   0   0   0   0   0   0   0   0   0   0   0   0   0   0   0   0   0   0   0   0   0   0   0   0   0   0   0   0   0   0   0   0   0   0   0   0   0   0   0   0   0   0   0   0   0   0   0   0   0   0   0   0   0   0   0   0   0   0   0   0   0   0   0   0   0   0   0   0   0   0   0   0   0   0   0   0   0   0   0   0   0   0   0   0   0   0   0   0   0   0   0   0   0   0   0   0   0   0   0   0   0   0   0   0   0   0   0   0   0   0   0   0   0   0   0   0   0   0   0   0   0   0   0   0   0   0   0   0   0   0   0   0   0   0   0   0   0   0   0   0   0   0   0   0   0   0   0   0   0  42  43  44  45   0   0   0   0   0   0   0   0   0   0   0   0   0   0   0   0   0   0   0   0   0   0   0   0   0   0   0   0   0   0   0   0   0   0   0   0   0   0   0   0   0   0   0   0   0   0   0   0   0   0   0   0   0   0   0   0   0   0   0   0   0   0   0   0   0   0   0   0   0   0   0   0   0   0   0   0   0   0   0   0   0   0   0   0   0   0   0   0   0   0   0   0   0   0   0   0   0   0   0   0   0   0   0   0   0   0   0   0   0   0   0   0 
  0   0   0   0   0   0   0   0   0   0   0   0   0   0   0   0   0   0   0   0   0   0   0   0   0   0   0   0   0   0   0   0   0   0   0   0   0   0   0   0   0   0   0   0   0   0   0   0   0   0   0   0   0   0   0   0   0   0   0   0   0   0   0   0   0   0   0   0   0   0   0   0   0   0   0   0   0   0   0   0   0   0   0   0   0   0   0   0   0   0   0   0   0   0   0   0   0   0   0   0   0   0   0   0   0   0   0   0   0   0   0   0   0   0   0   0   0   0   0   0   0   0   0   0   0   0   0   0   0   0   0   0   0   0   0   0   0   0   0   0   0   0   0   0  72  73  74  26   0   0   0   0   0   0   0   0   0   0   0   0   0   0   0   0   0   0   0   0   0   0   0   0   0   0   0   0   0   0   0   0   0   0   0   0   0   0   0   0   0   0   0   0   0   0   0   0   0   0   0   0   0   0   0   0   0   0   0   0   0   0   0   0   0   0   0   0   0   0   0   0   0   0   0   0   0   0   0   0   0   0   0   0   0   0   0   0   0   0   0   0   0   0   0   0   0   0   0   0   0   0   0   0   0   0   0   0   0   0   0   0   0   0   0   0   0   0   0   0   0   0   0   0   0   0   0   0   0   0   0   0   0   0   0   0   0   0   0   0   0   0   0   0   0   0   0   0   0   0   0   0   0   0   0   0   0   0   0   0   0   0   0   0   0   0   0   0   0   0   0   0 
  0   0   0   0   0   0   0   0   0   0   0   0   0   0   0   0   0   0   0   0   0   0   0   0   0   0   0   0   0   0   0   0   0   0   0   0   0   0   0   0   0   0   0   0   0   0   0   0   0   0   0   0   0   0   0   0   0   0   0   0   0   0   0   0   0   0   0   0   0   0   0   0   0   0   0   0   0   0   0   0   0   0   0   0   0   0   0   0   0   0   0   0   0   0   0   0   0   0   0   0   0   0   0   0   0   0   0   0   0   0   0   0   0   0   0   0   0   0   0   0   0   0   0   0   0   0   0   0   0   0   0   0   0   0   0   0   0   0   0   0   0   0   0   0  71  70  75  44   0   0   0   0   0   0   0   0   0   0   0   0   0   0   0   0   0   0   0   0   0   0   0   0   0   0   0   0   0   0   0   0   0   0   0   0   0   0   0   0   0   0   0   0   0   0   0   0   0   0   0   0   0   0   0   0   0   0   0   0   0   0   0   0   0   0   0   0   0   0   0   0   0   0   0   0   0   0   0   0   0   0   0   0   0   0   0   0   0   0   0   0   0   0   0   0   0   0   0   0   0   0   0   0   0   0   0   0   0   0   0   0   0   0   0   0   0   0   0   0   0   0   0   0   0   0   0   0   0   0   0   0   0   0   0   0   0   0   0   0   0   0   0   0   0   0   0   0   0   0   0   0   0   0   0   0   0   0   0   0   0   0   0   0   0   0   0   0   0   0   0   0 
  0   0   0   0   0   0   0   0   0   0   0   0   0   0   0   0   0   0   0   0   0   0   0   0   0   0   0   0   0   0   0   0   0   0   0   0   0   0   0   0   0   0   0   0   0   0   0   0   0   0   0   0   0   0   0   0   0   0   0   0   0   0   0   0   0   0   0   0   0   0   0   0   0   0   0   0   0   0   0   0   0   0   0   0   0   0   0   0   0   0   0   0   0   0   0   0   0   0   0   0   0   0   0   0   0   0   0   0   0   0   0   0   0   0   0   0   0   0   0   0   0   0   0   0   0   0   0   0   0   0   0   0   0   0   0   0   0   0   0   0   0   0   0   0  39  63  40  64   0   0   0   0   0   0   0   0   0   0   0   0   0   0   0   0   0   0   0   0   0   0   0   0   0   0   0   0   0   0   0   0   0   0   0   0   0   0   0   0   0   0   0   0   0   0   0   0   0   0   0   0   0   0   0   0   0   0   0   0   0   0   0   0   0   0   0   0   0   0   0   0   0   0   0   0   0   0   0   0   0   0   0   0   0   0   0   0   0   0   0   0   0   0   0   0   0   0   0   0   0   0   0   0   0   0   0   0   0   0   0   0   0   0   0   0   0   0   0   0   0   0   0   0   0   0   0   0   0   0   0   0   0   0   0   0   0   0   0   0   0   0   0   0   0   0   0   0   0   0   0   0   0   0   0   0   0   0   0   0   0   0   0   0   0   0   0   0   0   0   0   0 
  0   0   0   0   0   0   0   0   0   0   0   0   0   0   0   0   0   0   0   0   0   0   0   0   0   0   0   0   0   0   0   0   0   0   0   0   0   0   0   0   0   0   0   0   0   0   0   0   0   0   0   0   0   0   0   0   0   0   0   0   0   0   0   0   0   0   0   0   0   0   0   0   0   0   0   0   0   0   0   0   0   0   0   0   0   0   0   0   0   0   0   0   0   0   0   0   0   0   0   0   0   0   0   0   0   0   0   0   0   0   0   0   0   0   0   0   0   0   0   0   0   0   0   0   0   0   0   0   0   0   0   0   0   0   0   0   0   0   0   0   0   0   0   0  67  40  68  41   0   0   0   0   0   0   0   0   0   0   0   0   0   0   0   0   0   0   0   0   0   0   0   0   0   0   0   0   0   0   0   0   0   0   0   0   0   0   0   0   0   0   0   0   0   0   0   0   0   0   0   0   0   0   0   0   0   0   0   0   0   0   0   0   0   0   0   0   0   0   0   0   0   0   0   0   0   0   0   0   0   0   0   0   0   0   0   0   0   0   0   0   0   0   0   0   0   0   0   0   0   0   0   0   0   0   0   0   0   0   0   0   0   0   0   0   0   0   0   0   0   0   0   0   0   0   0   0   0   0   0   0   0   0   0   0   0   0   0   0   0   0   0   0   0   0   0   0   0   0   0   0   0   0   0   0   0   0   0   0   0   0   0   0   0   0   0   0   0   0   0   0 
  0   0   0   0   0   0   0   0   0   0   0   0   0   0   0   0   0   0   0   0   0   0   0   0   0   0   0   0   0   0   0   0   0   0   0   0   0   0   0   0  76  73  77  78   0   0   0   0   0   0   0   0   0   0   0   0   0   0   0   0   0   0   0   0   0   0   0   0   0   0   0   0   0   0   0   0   0   0   0   0   0   0   0   0   0   0   0   0  76  73  77  78  76  73  77  78   0   0   0   0   0   0   0   0   0   0   0   0   0   0   0   0   0   0   0   0   0   0   0   0  79  73  77  78   0   0   0   0   0   0   0   0   0   0   0   0   0   0   0   0   0   0   0   0  54  55  56  57  76  73  77  78   0   0   0   0   0   0   0   0   0   0   0   0   0   0   0   0   0   0   0   0   0   0   0   0   0   0   0   0   0   0   0   0   0   0   0   0   0   0   0   0   0   0   0   0   0   0   0   0   0   0   0   0   0   0   0   0   0   0   0   0   0   0   0   0   0   0   0   0   0   0   0   0   0   0   0   0  76  73  74  26   0   0   0   0   0   0   0   0   0   0   0   0   0   0   0   0   0   0   0   0   0   0   0   0   0   0   0   0   0   0   0   0   0   0   0   0   0   0   0   0   0   0   0   0   0   0   0   0   0   0   0   0   0   0   0   0   0   0   0   0   0   0   0   0   0   0   0   0   0   0   0   0   0   0   0   0   0   0   0   0   0   0   0   0   0   0   0   0 
  0   0   0   0   0   0   0   0   0   0   0   0   0   0   0   0   0   0   0   0   0   0   0   0   0   0   0   0   0   0   0   0   0   0   0   0   0   0   0   0  80  81  75  82   0   0   0   0   0   0   0   0   0   0   0   0   0   0   0   0   0   0   0   0   0   0   0   0   0   0   0   0   0   0   0   0   0   0   0   0   0   0   0   0   0   0   0   0  80  81  75  82  80  81  75  82   0   0   0   0   0   0   0   0   0   0   0   0   0   0   0   0   0   0   0   0   0   0   0   0  80  81  75  82   0   0   0   0   0   0   0   0   0   0   0   0   0   0   0   0   0   0   0   0  70  60  61  71  80  81  75  82   0   0   0   0   0   0   0   0   0   0   0   0   0   0   0   0   0   0   0   0   0   0   0   0   0   0   0   0   0   0   0   0   0   0   0   0   0   0   0   0   0   0   0   0   0   0   0   0   0   0   0   0   0   0   0   0   0   0   0   0   0   0   0   0   0   0   0   0   0   0   0   0   0   0   0   0  71  70  75  44   0   0   0   0   0   0   0   0   0   0   0   0   0   0   0   0   0   0   0   0   0   0   0   0   0   0   0   0   0   0   0   0   0   0   0   0   0   0   0   0   0   0   0   0   0   0   0   0   0   0   0   0   0   0   0   0   0   0   0   0   0   0   0   0   0   0   0   0   0   0   0   0   0   0   0   0   0   0   0   0   0   0   0   0   0   0   0   0 
  0   0   0   0   0   0   0   0   0   0   0   0   0   0   0   0   0   0   0   0   0   0   0   0   0   0   0   0   0   0   0   0   0   0   0   0   0   0   0   0  28  29  30  31   0   0   0   0   0   0   0   0   0   0   0   0   0   0   0   0   0   0   0   0   0   0   0   0   0   0   0   0   0   0   0   0   0   0   0   0   0   0   0   0   0   0   0   0  28  29  30  31  28  29  30  31   0   0   0   0   0   0   0   0   0   0   0   0   0   0   0   0   0   0   0   0   0   0   0   0  28  29  30  31   0   0   0   0   0   0   0   0   0   0   0   0   0   0   0   0   0   0   0   0  28  29  30  31  28  29  30  31   0   0   0   0   0   0   0   0   0   0   0   0   0   0   0   0   0   0   0   0   0   0   0   0   0   0   0   0   0   0   0   0   0   0   0   0   0   0   0   0   0   0   0   0   0   0   0   0   0   0   0   0   0   0   0   0   0   0   0   0   0   0   0   0   0   0   0   0   0   0   0   0   0   0   0   0  28  29  30  31   0   0   0   0   0   0   0   0   0   0   0   0   0   0   0   0   0   0   0   0   0   0   0   0   0   0   0   0   0   0   0   0   0   0   0   0   0   0   0   0   0   0   0   0   0   0   0   0   0   0   0   0   0   0   0   0   0   0   0   0   0   0   0   0   0   0   0   0   0   0   0   0   0   0   0   0   0   0   0   0   0   0   0   0   0   0   0   0 
  0   0   0   0   0   0   0   0   0   0   0   0   0   0   0   0   0   0   0   0   0   0   0   0   0   0   0   0   0   0   0   0   0   0   0   0   0   0   0   0  83  50  84  41   0   0   0   0   0   0   0   0   0   0   0   0   0   0   0   0   0   0   0   0   0   0   0   0   0   0   0   0   0   0   0   0   0   0   0   0   0   0   0   0   0   0   0   0  83  50  48  41  83  47  85  41   0   0   0   0   0   0   0   0   0   0   0   0   0   0   0   0   0   0   0   0   0   0   0   0  83  50  49  41   0   0   0   0   0   0   0   0   0   0   0   0   0   0   0   0   0   0   0   0  83  50  48  41  83  47  48  41   0   0   0   0   0   0   0   0   0   0   0   0   0   0   0   0   0   0   0   0   0   0   0   0   0   0   0   0   0   0   0   0   0   0   0   0   0   0   0   0   0   0   0   0   0   0   0   0   0   0   0   0   0   0   0   0   0   0   0   0   0   0   0   0   0   0   0   0   0   0   0   0   0   0   0   0  83  50  85  41   0   0   0   0   0   0   0   0   0   0   0   0   0   0   0   0   0   0   0   0   0   0   0   0   0   0   0   0   0   0   0   0   0   0   0   0   0   0   0   0   0   0   0   0   0   0   0   0   0   0   0   0   0   0   0  86   0   0   0   0  87   0   0   0   0   0   0   0   0   0   0   0   0   0   0   0   0   0   0   0   0   0   0   0   0   0   0   0 
  0   0   0   0   0   0   0   0   0   0   0   0   0   0   0   0   0   0   0   0   0   0   0   0   0   0   0   0   0   0   0   0   0   0   0   0   0   0   0   0  88  83  56  57  76  73  77  78   0   0   0   0   0   0   0   0   0   0   0   0  76  73  77  78   0   0   0   0   0   0   0   0   0   0   0   0   0   0   0   0   0   0   0   0  76  73  77  78  88  83  56  57  88  83  56  57  76  73  77  78   0   0   0   0   0   0   0   0   0   0   0   0   0   0   0   0   0   0   0   0  88  83  56  57   0   0   0   0   0   0   0   0   0   0   0   0   0   0   0   0  76  73  77  78  88  83  56  57  88  83  56  57  76  73  77  78   0   0   0   0   0   0   0   0   0   0   0   0   0   0   0   0   0   0   0   0   0   0   0   0   0   0   0   0   0   0   0   0   0   0   0   0  89  90  86  87  86  87  89  90   0   0   0   0   0   0   0   0   0   0   0   0   0   0   0   0   0   0   0   0   0   0   0   0   0   0   0   0  88  83  56  57  76  73  77  78   0   0   0   0   0   0   0   0   0   0   0   0   0   0   0   0   0   0  91  87  92  93  93  94  86  87   0   0   0   0   0   0   0   0   0   0   0   0  86  87  86  87   0   0   0   0   0   0   0  86  87  92  92  93  93  94  94  86  87   0   0   0   0   0   0   0  86  87  86  87   0   0   0   0  86  87  86  87   0   0   0   0   0   0 
  0   0   0   0   0   0   0   0   0  95  96   0   0   0   0   0   0   0   0   0   0   0   0   0   0   0   0   0   0   0   0   0   0   0   0   0   0  95  96   0  97  98  61  99  80  81  75  82   0   0   0   0   0   0   0   0   0  95  96   0  80  81  75  82   0   0   0   0   0   0   0   0   0   0   0   0   0   0   0   0   0  95  96   0  80  81  75  82  97  98  61  99  97  98  61  99  80  81 100  82   0   0   0   0   0   0   0   0   0   0   0   0   0   0   0   0   0  95  96   0  97  98  61  99   0  95  96   0   0   0   0   0   0   0   0   0   0   0   0   0  80  81  75  82  97  98  61  99  97  98  61  99  80  81  75  82   0   0   0   0   0   0   0   0   0   0   0   0   0   0   0   0   0  95  96   0   0   0   0   0   0   0   0   0   0   0   0   0   0   0  89  90 101 102 103 104 105 106 101 102  89  90   0   0   0   0   0   0   0   0   0   0   0   0   0   0   0   0   0   0   0   0   0   0   0   0   0   0  97  98  61  99  80  81 100  82   0   0   0   0   0   0   0   0   0   0   0   0   0   0   0   0   0   0 103 104 105 104 105 104 105 106   0   0   0  95  96   0   0   0   0   0   0   0 103 104 105 106   0   0   0   0   0   0   0 103 104 105 105 104 105 104 104 105 106   0   0   0   0   0   0   0 103 104 105 106   0   0   0   0 103 104 105 106   0   0   0   0   0   0 
  0   0 107   0   0   0 107 108 109 110 111 112  95 113   0   0   0   0   0  95  95   0  95   0   0   0   0   0   0   0 107 108  95   0  95   0 109 110 111 112 114 115 116 117 111 109 110 112  95 113   0   0   0   0   0  95 109 109 110 107 111 109 110 112   0   0   0   0   0   0  95   0   0   0   0   0   0   0   0  95 109 109 110 107 109 110 111 112 111 109 110 112 114 115 116 117 111 109 110 112  95   0  95   0 109 109 110 107   0   0   0   0  95 113   0   0 109 110 111 112 114 115 116 117 109 110 111 112   0   0 107 108   0   0   0  95 109 112   0 118 111 109 110 112 114 115 116 117 114 115 116 117 111 109 110 112   0   0 107 108  95   0  95   0   0   0   0   0 109 110 111 112 109 110 111 112   0   0   0   0  95 113   0   0   0   0   0   0  95   0 101 102  86  92 119 120 119 120  94  87 101 102   0  95   0   0   0   0  95 113   0   0  95   0  95   0   0   0   0   0   0   0  95   0 109 112   0 118 114 115 116 117 109 110 111 112 109 109 110 107   0   0  95   0   0   0   0   0   0   0   0  95   0  86  92 120 119 120 119 120 119  94  87   0 109 110 111 112  95   0  95   0   0  86  92 120 119  94  87   0  95   0  95   0   0  86  92 120 119 120 119 120 119  94  87   0  95   0  95   0   0  86  92 120 119  94  87   0   0  86  92 120 119  94  87   0   0 113 108   0 
121 122 123 122 124 125 123 122 123 122 122 122 123 122 125 124 122 125 122 123 123 122 122 122 125 122 124 122 124 125 123 122 123 122 122 122 123 122 122 122 123 124 122 124 122 123 124 122 123 122 125 124 122 125 122 123 122 122 123 125 122 123 124 122 124 125 123 122 123 122 122 122 125 122 124 122 122 125 122 123 122 122 123 125 123 122 122 122 122 123 124 122 123 124 122 124 122 123 124 122 123 122 122 122 122 122 123 125 125 122 124 122 123 122 125 124 123 122 122 122 123 124 122 124 123 122 122 122 124 125 123 122 122 125 122 123 123 124 122 123 122 123 124 122 123 124 122 124 123 124 122 124 122 123 124 122 124 125 123 122 123 122 122 122 125 122 124 122 123 122 122 122 123 122 122 122 125 122 124 122 123 122 125 124 125 122 124 122 123 122 122 122 123 125 124 122 125 122 122 125 122 125 122 123 125 122 124 122 123 122 125 124 123 122 122 122 125 122 124 122 123 122 122 122 123 124 122 123 123 124 122 124 123 122 122 122 122 122 123 125 123 122 122 122 125 122 124 122 122 125 122 123 126 122 124 123 122 122 124 125 122 124 122 123 123 122 122 122 123 122 122 122 125 122 124 123 122 124 122 123 123 122 122 122 125 122 124 123 122 122 124 125 122 124 122 123 123 122 122 122 125 122 124 123 122 124 122 123 125 122 124 123 122 124 122 123 125 122 123 127 

// BOUNDS indice top, left, bottom, right en %
[BOUNDS]
default  0  0      0 0  // default de 100%
  7      0  0  -0.75 0  // le bas est rogné de 75%
  8      0  0 -0.625 0
 13      0  0 -0.625 0
 15      0  0  -0.75 0
 95  -0.75  0      0 0
107  -0.75  0      0 0
108 -0.625  0      0 0
113 -0.625  0      0 0